11111111111111111
10P11F11FCF000011
100100C110001F011
1F0F0FF01010F0C01
11000FC010FE1F001
1101000F101010001
100F1F00000000FE1
11111111111111111