1111111111111
1F010000000C1
10P0011111F01
1E00110000001
1111111111111